        
 ##############
 #            #
 #  *         #
 #            #
 ##############