        
 ##############
 #            #
 # *          #
 #            #
 ##############