##############
#            #
#     *      #
#            #
##############