##############
#            #
#            #
#*           #
##############