        
 ##############
 #            #
 #       *    #
 #            #
 ##############