#######
#     #
#  *  #
#     #
#######