################
#   #          #
#        #   * #
#   #  #       #
################