##########################################
#         #                    ###       #
#   ###    ####          #               #
#     #    #       #     #       ##      #
#     #    ####    #     #        #      #
#                  #     #        #   #  #
#    #     #       #     ###             #
#    #     #       ##                 #  #
#          #               *             #
#     #                                  #
##########################################